BBBBBBBBBBBBBBBBBBB
B                 B
B                 B
B                 B
B  1111111111111  B
B  1111333331111  B
B  1111111111111  B
B  1111222221111  B
B  1111111111111  B
B                 B
B                 B
B                 B
B                 B
B                 B
B                 B
B                 B
B                 B
B                 B