BBBBBBBBBBBBBBBBBBBBBBBBBBBBBB
B                            B
B        444444444444        B
B      3333333333333333      B
B  111222222222222222222111  B
B1111111111111111111111111111B
B                            B
B                            B
B                            B
B                            B
B                            B
B                            B
B                            B
B                            B
B                            B